#################################
#                               #
#                               #
#   ##P                         #
#   ##                          #
#                               #
#M                              #
#################################