#################################
#                               #
#                R         H    #
#   ##P                         #
#   ##                          #
# F                             #
#                               #
#################################