##############################################################################
##############################################################################
                                                                             #
                                                                             #
                                                                             #
                                                                             #
                                                                             #
                                                                             #
                                                                             #
#####  ######                                                                #
#                                                                            #
#                                                                            #
#                                                                            #
#                                                                            #
#                                                                            #
#                                                                            #
#                                                                            #
#                                                                            #
#                                                                            #
#                                                                            #
#                                                                            #
#                                                                            #
#                                                                            #
#                                                                            #
#                                                                            #
#                                                                            #
#                                                                            #
#                                                                            #
#                                                                            #
#                                                                            #
#                                                                            #
#                                                                            #
#                                                                            #
#                                                                            #
#                                                                            #
#                                                                            #
#                                                                            #
#                                                                            #
#                                                                            #
#                                                                            #
#                                                                            #
#                                                                            #
#                                                                            #
#                                                                            #
#                                                                            #
#                                                                            #
#                                                                            #
#                                                                            #
#                                                                            #
##############################################################################