#################################
#                               #
#                               #
#   ##P                         #
#   ##                          #
#                               #
#                               #
#################################