#######################################
#######################################
#                                     #
#                R               H    #
#     P                               #
#                                     #
# F                                   #
#                                     #
#                                     #
#                                     #
#######################################