############
#    M     #
#          #
#    ##    #
#    ##    #
#    ##    #
#    ##    #
#          #
#          #
############