#######################################
#                                     #
#                R               H    #
#   ##P                               #
#   ##                                #
# F                                   #
#                                     #
#                                     #
#                                     #
#######################################